######_________######
######_________######
######_________######
######_________######
######_________######
######_________######
#__________________#
#__________________#
#__________________#
#__________________#
#__________________#
#__________________#
#__________________#
#__________________#
######_________######
######_________######
######_________######
######_________######
######_________######
######_________######